# 位置与Unity的世界坐标对应，值为格子id
[Terrain Data]
0,0,1,1,1,1,1,1,1,1,1,1,1,1,1,1,1,1
0,1,1,1,1,1,1,1,1,1,1,1,1,1,1,1,1,1,1
1,1,1,1,1,1,1,1,1,1,1,1,1,1,1,1,1,1,1
1,1,1,1,1,1,1,1,1,1,1,1,1,1,1,1,1,1,1,1
1,1,1,1,1,1,1,1,1,1,,0,0,0,1,1,1,1,1,1
0,1,1,1,1,1,1,1,1,1,0,0,0,1,1,1,1,1,1
0,0,0,1,1,1,1,1,1,0,0,0,1,1,1,1,1,1
0,0,0,1,1,1,1,1,1,0,0,0,1,1,1,1,1,1
[Terrain Data]

# 分别为单位的CLass ID，世界坐标( x , y )
[Unit Data]
20005,8,2
20001,9,7
20001,6,4
20002,12,5
[Unit Data]

