# 位置与Unity的世界坐标对应，值为格子id
[Terrain Data]
0,0,0,0,1,1,1,1,1,0,0,0,0,1,1,1
0,0,1,1,1,1,1,1,1,1,0,0,1,1,1,1
0,1,1,1,1,1,1,1,1,1,1,1,1,1,1,1,1
1,1,1,1,1,1,1,1,1,1,1,1,1,1,1,1,1
1,1,1,1,1,1,1,1,1,1,1,1,1,1,1,1
0,0,1,1,1,1,1,1,1,1,1,1,1,1
0,0,0,1,1,1,1,1,1,1,1,1,1,1,1
0,0,0,1,1,1,1,1,1,1,1,1,1,1,1
[Terrain Data]

# 分别为单位的CLass ID，世界坐标( x , y )
[Unit Data]
20003,15,7
20003,14,4
20004,14,6
20003,12,5
[Unit Data]

