[Gold]
70
[Gold]
# 位置与Unity的世界坐标对应，值为格子id
[Terrain Data]
0,0,0,0,0,0,0,0,0,0,0,1,1,1,1,1,1
1,1,1,1,1,1,1,1,1,1,1,1,1,1,1,1,1
1,1,1,1,1,1,1,1,1,1,1,1,1,1,1,1,1
1,1,1,0,1,1,1,1,1,1,1,1,1,1,1,1,1
0,0,0,0,1,1,1,1,1,2,2,1,1,1,1,1,1
0,0,0,1,1,1,1,1,1,2,2,1,1,1,1,1,1
0,0,1,1,1,1,1,1,1,2,2,1,1,1,1,1,1
1,1,1,1,1,1,1,1,1,2,2,1,1,1,1,1,1
[Terrain Data]

# 分别为单位的CLass ID，世界坐标( x , y )
[Unit Data]
20003,13,0
20003,14,3
20004,15,2
20003,13,5
[Unit Data]

