# 位置与Unity的世界坐标对应，值为格子id
[Terrain Data]
0,0,1,1,1,1,1,1,1,1,1,1,1,1,1,1,1,1
0,1,1,1,1,1,1,1,1,1,1,1,1,1,1,1,1,1,1
1,1,1,1,1,1,1,1,1,1,1,1,1,1,1,1,1,1,1
1,1,1,1,1,1,1,1,1,1,1,1,1,1,1,1,1,1,1,1
1,1,1,1,1,1,1,1,1,1,,0,0,0,1,1,1,1,1,1
0,1,1,1,1,1,1,1,1,1,0,0,0,1,1,1,1,1,1
0,0,0,1,1,1,1,1,1,0,0,0,1,1,1,1,1,1
0,0,0,1,1,1,1,1,1,0,0,0,1,1,1,1,1,1
[Terrain Data]

# 分别为单位的CLass ID，世界坐标( x , y )
[Unit Data]
20003,8,2
20003,3,4
20003,4,6
20003,6,5
20003,8,3
[Unit Data]

